1111111111
1110000111
101C000C11
1001000001
10CC110001
1000P10001
10C00E1001
1000000001
1000000C11
1111111111