111111111111111
111000011000001
1110P0001000001
100101000000001
101010000000001
100001000000001
10000E100000001
100000010000001
101000001000001
100000000100001
101000000010001
100000000001001
101000000000101
111111111111111