1111111111111111111111111111111111111111111111111111111111111111111111
1110000110000010010100000000001010000000000101000000000010100000000001
111000C0100000001010000000C0010100000000001010000000000101000000000101
100101000000C0001010000000000000000C0000000000000000000000000000000001
1000000000000C000000000000000C00000C0000000000000000000000000000000001
1000000000001000000000100000000000000000000000001000000000000C00000001
100000E000000000000000000000000000010000000000000000000000000000000001
100000000000000000100000C000001000010000000000000000000000000000000001
1000000000000000000100000000000000010000000000000000000000000000000001
10000000000000000000000000001100000000000000010000000000C0000000000001
1000000000000C00000000000100000000100000010000000000000000000000000001
100000010000CC00000000000000000000000000010000000000000000000100000001
1000000000000000000000000000000010000000011110000100000000000000000001
10000000000000000000000100000000C0000000100000000000000P00000000000001
10000000000000000C0000000000000000000000000000000000000000000000000001
1000000000000000000000000000000000000000000000000000C00000000000000001
100000000000100000000000000C000100001100000000C00000000C00000000000001
1000000000000000000000000000000000000000000000000000000000000000000011
1111111111111111111111111111111111111111111111111111111111111111111111